WWWWWWWWWWWWWWWWWWW
WSSSSWSSSSSSSWSSSSW
WBWWSWSWWWWWSWSWWBW
WSSWSSSSSWSSSSSWSSW
WWSWSWSWSWSWSWSWSWW
EESSSWSWSWSWSWSSSEE
WWSWSWSWSSSWSWSWSWW
EWSWSWSWWWWWSWSWSWE
WWSWSSEEEEEEESSWSWW
WSSSSWEWEWEWEWSSSSW
WWSWWWEW1E2WEWWWSWW
WSSSSWEWWWWWEWSSSSW
WSWWSWEEEEEEEWSWWSW
WSSWSWSWWWWWSWSWSSW
WWSWSWSSSWSSSWSWSWW
EESSSSSWSPSWSSSSSEE
WWSWSWWWSWSWWWSWSWW
WSSWSSSSSWSSSSSWSSW
WBWWSWSWWWWWSWSWWBW
WSSSSWSSSSSSSWSSSSW
WWWWWWWWWWWWWWWWWWW