WWWWWWWWWWWWWWWWWWW
WSSSSSSSSWSSSSSSSSW
WBWWSWWWWWWWWWSWWBW
WSSSSSSSSSSSSSSSSSW
WSWWSWSWWWWWSWSWWSW
WSSSSWSSSWSSSWSSSSW
WWWWSWWWEWEWWWSWWWW
EEEWSWEEEEEEEWSWEEE
WWWWSWEWEWEWEWSWWWW
EEEESEEW1E2WEESEEEE
WWWWSWEWWWWWEWSWWWW
EEEWSWEEEEEEEWSWEEE
WWWWSWEWWWWWEWSWWWW
WSSSSSSSSWSSSSSSSSW
WBWWSWWWWWWWWWSWWBW
WSSWSSSSSPSSSSSWSSW
WWSWSWSWWWWWSWSWSWW
WSSSSWSSSWSSSWSSSSW
WSWWWWWWSWSWWWWWWSW
WSSSSSSSSSSSSSSSSSW
WWWWWWWWWWWWWWWWWWW