WWWWWWWWWWWWWWWWWWW
WSSSSWSSSSSSSWSSSSW
WBWWSWSWWWWWSWSWWBW
WSSSSSSSSSSSSSSSSSW
WWSWSWWWSWSWWWSWSWW
EESWSSSSSWSSSSSWSEE
WWSWWWSWWWWWSWWWSWW
EWSSSSEEEEEEESSSSWE
EWSWWWEWEWEWEWWWSWE
EWSWSSEW1E2WESSWSWE
WWSWSWEWWWWWEWSWSWW
EESSSWEEEEEEEWSSSEE
WWSWWWWWSWSWWWWWSWW
EWSSSSSSSWSSSSSSSWE
WWSWWWSWWWWWSWWWSWW
WSSSSSSSSPSSSSSSSSW
WSWWSWWWSWSWWWSWWSW
WSWWSWSSSWSSSWSWWSW
WBWWSWSWWWWWSWSWWBW
WSSSSSSSSSSSSSSSSSW
WWWWWWWWWWWWWWWWWWW